"year","abbreviation","state","democratic","republican","total","fraction_democratic","fraction_republican","electoral_votes"
2000,"AK","Alaska",79004,167398,246402,0.320630514362708,0.679369485637292,3
2000,"AL","Alabama",692611,941173,1633784,0.423930580786689,0.576069419213311,9
2000,"AR","Arkansas",422768,472940,895708,0.471993104895792,0.528006895104208,6
2000,"AZ","Arizona",685341,781652,1466993,0.467174008328601,0.532825991671399,10
2000,"CA","California",5861203,4567429,10428632,0.562029899990718,0.437970100009282,55
2000,"CO","Colorado",738227,883748,1621975,0.45514080056721,0.54485919943279,9
2000,"CT","Connecticut",816015,561094,1377109,0.592556580488545,0.407443419511455,7
2000,"DC","D.C.",171923,18073,189996,0.904876944777785,0.0951230552222152,3
2000,"DE","Delaware",180068,137288,317356,0.567400647852884,0.432599352147116,3
2000,"FL","Florida",2912253,2912790,5825043,0.499953905919664,0.500046094080336,27
2000,"GA","Georgia",1116230,1419720,2535950,0.440162463770973,0.559837536229027,15
2000,"HI","Hawaii",205286,137845,343131,0.598272962804293,0.401727037195707,4
2000,"IA","Iowa",638517,634373,1272890,0.501627791875182,0.498372208124818,7
2000,"ID","Idaho",138637,336937,475574,0.29151509544256,0.70848490455744,4
2000,"IL","Illinois",2589026,2019421,4608447,0.561800103158396,0.438199896841604,21
2000,"IN","Indiana",901980,1245836,2147816,0.419952174674181,0.580047825325819,11
2000,"KS","Kansas",399276,622332,1021608,0.390830925364719,0.609169074635281,6
2000,"KY","Kentucky",638898,872492,1511390,0.422722129959838,0.577277870040162,8
2000,"LA","Louisiana",792344,927871,1720215,0.460607540336528,0.539392459663472,9
2000,"MA","Massachusetts",1616487,878502,2494989,0.647893437606338,0.352106562393662,12
2000,"MD","Maryland",1145782,813797,1959579,0.584708246005902,0.415291753994098,10
2000,"ME","Maine",319951,286616,606567,0.527478415410004,0.472521584589996,4
2000,"MI","Michigan",2170418,1953139,4123557,0.526346064817341,0.473653935182659,17
2000,"MN","Minnesota",1168266,1109659,2277925,0.512864119758113,0.487135880241887,10
2000,"MO","Missouri",1111138,1189924,2301062,0.482880513432493,0.517119486567507,11
2000,"MS","Mississippi",404614,572844,977458,0.413945151607537,0.586054848392463,6
2000,"MT","Montana",137126,240178,377304,0.363436380213303,0.636563619786697,3
2000,"NC","North Carolina",1257692,1631163,2888855,0.435360030184969,0.564639969815031,15
2000,"ND","North Dakota",95284,174852,270136,0.352726034293837,0.647273965706163,3
2000,"NE","Nebraska",231780,433862,665642,0.34820519137915,0.65179480862085,5
2000,"NH","New Hampshire",266348,273559,539907,0.493321998047812,0.506678001952188,4
2000,"NJ","New Jersey",1788850,1284173,3073023,0.582114094167209,0.417885905832791,15
2000,"NM","New Mexico",286783,286417,573200,0.500319260293091,0.499680739706909,5
2000,"NV","Nevada",279978,301575,581553,0.481431615003276,0.518568384996724,5
2000,"NY","New York",4107697,2403374,6511071,0.630878852342418,0.369121147657582,31
2000,"OH","Ohio",2186190,2351209,4537399,0.481815683390418,0.518184316609582,20
2000,"OK","Oklahoma",474276,744337,1218613,0.389193287778811,0.610806712221189,7
2000,"OR","Oregon",720342,713577,1433919,0.502358919855306,0.497641080144694,7
2000,"PA","Pennsylvania",2485967,2281127,4767094,0.521484787168031,0.478515212831969,21
2000,"RI","Rhode Island",249508,130555,380063,0.656491160675993,0.343508839324007,4
2000,"SC","South Carolina",565561,785937,1351498,0.418469727665154,0.581530272334846,8
2000,"SD","South Dakota",118804,190700,309504,0.383852874276261,0.616147125723739,3
2000,"TN","Tennessee",981720,1061949,2043669,0.48037133214821,0.51962866785179,11
2000,"TX","Texas",2433746,3799639,6233385,0.390437298514371,0.609562701485629,34
2000,"UT","Utah",203053,515096,718149,0.282744945686759,0.717255054313241,5
2000,"VA","Virginia",1217290,1437490,2654780,0.458527636941667,0.541472363058332,13
2000,"VT","Vermont",149022,119775,268797,0.554403508967734,0.445596491032266,3
2000,"WA","Washington",1247652,1108864,2356516,0.529447710094054,0.470552289905946,11
2000,"WI","Wisconsin",1242987,1237279,2480266,0.501150683031578,0.498849316968422,10
2000,"WV","West Virginia",295497,336475,631972,0.467579259840626,0.532420740159374,5
2000,"WY","Wyoming",60481,147947,208428,0.29017694359683,0.70982305640317,3
2000,"US","United States",50999897,50456002,101455899,0.502680450350157,0.497319549649843,538
2004,"AK","Alaska",111025,190889,301914,0.367737170187537,0.632262829812463,3
2004,"AL","Alabama",693933,1176394,1870327,0.371022286477177,0.628977713522823,9
2004,"AR","Arkansas",469953,572898,1042851,0.450642517483322,0.549357482516678,6
2004,"AZ","Arizona",893524,1104294,1997818,0.447249949695117,0.552750050304883,10
2004,"CA","California",6745485,5509826,12255311,0.550413204528225,0.449586795471775,55
2004,"CO","Colorado",1001732,1101255,2102987,0.476337704417574,0.523662295582426,9
2004,"CT","Connecticut",857488,693826,1551314,0.552749475605841,0.447250524394159,7
2004,"DC","D.C.",202970,21256,224226,0.905202786474361,0.0947972135256393,3
2004,"DE","Delaware",200152,171660,371812,0.538315062450916,0.461684937549084,3
2004,"FL","Florida",3583544,3964522,7548066,0.474763204243312,0.525236795756688,27
2004,"GA","Georgia",1366149,1914254,3280403,0.416457673035904,0.583542326964096,15
2004,"HI","Hawaii",231708,194191,425899,0.544044480029303,0.455955519970697,4
2004,"IA","Iowa",741898,751957,1493855,0.496633207372871,0.503366792627129,7
2004,"ID","Idaho",181098,409235,590333,0.306772618166357,0.693227381833643,4
2004,"IL","Illinois",2891550,2345946,5237496,0.552086340495535,0.447913659504465,21
2004,"IN","Indiana",969011,1479438,2448449,0.395765237503415,0.604234762496585,11
2004,"KS","Kansas",434993,736456,1171449,0.371329012189178,0.628670987810822,6
2004,"KY","Kentucky",712733,1069439,1782172,0.399923800845261,0.600076199154739,8
2004,"LA","Louisiana",820299,1102169,1922468,0.426690587307565,0.573309412692435,9
2004,"MA","Massachusetts",1803800,1071109,2874909,0.627428555129919,0.372571444870081,12
2004,"MD","Maryland",1334493,1024703,2359196,0.565655842075012,0.434344157924988,10
2004,"ME","Maine",396842,330201,727043,0.545830164103086,0.454169835896914,4
2004,"MI","Michigan",2479183,2313746,4792929,0.517258444679652,0.482741555320348,17
2004,"MN","Minnesota",1445014,1346695,2791709,0.51760910610669,0.482390893893311,10
2004,"MO","Missouri",1259171,1455713,2714884,0.463802873345601,0.536197126654398,11
2004,"MS","Mississippi",458094,684981,1143075,0.400755855914966,0.599244144085034,6
2004,"MT","Montana",173710,266063,439773,0.394999238243366,0.605000761756634,3
2004,"NC","North Carolina",1525849,1961166,3487015,0.437580279981589,0.562419720018411,15
2004,"ND","North Dakota",111052,196651,307703,0.360906458500567,0.639093541499433,3
2004,"NE","Nebraska",254328,512814,767142,0.331526627404053,0.668473372595947,5
2004,"NH","New Hampshire",340511,331237,671748,0.506902886201373,0.493097113798627,4
2004,"NJ","New Jersey",1911430,1670003,3581433,0.533705363188422,0.466294636811578,15
2004,"NM","New Mexico",370942,376930,747872,0.495996641136451,0.504003358863549,5
2004,"NV","Nevada",397190,418690,815880,0.486824042751385,0.513175957248615,5
2004,"NY","New York",4314280,2962567,7276847,0.592877657040199,0.407122342959801,31
2004,"OH","Ohio",2741167,2859768,5600935,0.489412392752282,0.510587607247718,20
2004,"OK","Oklahoma",503966,959792,1463758,0.344295983352439,0.655704016647561,7
2004,"OR","Oregon",943163,866831,1809994,0.521086257744501,0.478913742255499,7
2004,"PA","Pennsylvania",2938095,2793847,5731942,0.512582820970624,0.487417179029376,21
2004,"RI","Rhode Island",259765,169046,428811,0.605779702479647,0.394220297520353,4
2004,"SC","South Carolina",661699,937974,1599673,0.413646413985858,0.586353586014142,8
2004,"SD","South Dakota",149244,232584,381828,0.390867091989063,0.609132908010937,3
2004,"TN","Tennessee",1036477,1384375,2420852,0.428145545452593,0.571854454547407,11
2004,"TX","Texas",2832704,4526917,7359621,0.384898081028901,0.615101918971099,34
2004,"UT","Utah",241199,663742,904941,0.26653560839878,0.73346439160122,5
2004,"VA","Virginia",1454742,1716959,3171701,0.458663032864699,0.541336967135301,13
2004,"VT","Vermont",184067,121180,305247,0.603010021392512,0.396989978607488,3
2004,"WA","Washington",1510201,1304894,2815095,0.53646537683453,0.46353462316547,11
2004,"WI","Wisconsin",1489504,1478120,2967624,0.501918032742692,0.498081967257308,10
2004,"WV","West Virginia",326541,423778,750319,0.435202893702545,0.564797106297455,5
2004,"WY","Wyoming",70776,167629,238405,0.296872968268283,0.703127031731717,3
2004,"US","United States",59028444,62040610,121069054,0.487560132418314,0.512439867581686,538
2008,"AK","Alaska",123594,193841,317435,0.389352150834029,0.610647849165971,3
2008,"AL","Alabama",813479,1266546,2080025,0.391090972464273,0.608909027535727,9
2008,"AR","Arkansas",422310,638017,1060327,0.398282793892827,0.601717206107173,6
2008,"AZ","Arizona",1034707,1230111,2264818,0.456860992803837,0.543139007196163,10
2008,"CA","California",8274473,5011781,13286254,0.622784495915854,0.377215504084146,55
2008,"CO","Colorado",1288633,1073629,2362262,0.545508076580837,0.454491923419164,9
2008,"CT","Connecticut",997772,629428,1627200,0.613183382497542,0.386816617502458,7
2008,"DC","D.C.",245800,17367,263167,0.934007683334157,0.0659923166658434,3
2008,"DE","Delaware",255459,152374,407833,0.626381386498886,0.373618613501114,3
2008,"FL","Florida",4282074,4045624,8327698,0.514196600308993,0.485803399691007,27
2008,"GA","Georgia",1844123,2048759,3892882,0.473716644891882,0.526283355108118,15
2008,"HI","Hawaii",325871,120566,446437,0.729937258784554,0.270062741215446,4
2008,"IA","Iowa",828940,682379,1511319,0.548487777894674,0.451512222105327,7
2008,"ID","Idaho",236440,403012,639452,0.369754101949795,0.630245898050205,4
2008,"IL","Illinois",3419348,2031179,5450527,0.627342640445594,0.372657359554406,21
2008,"IN","Indiana",1374039,1345648,2719687,0.505219534453781,0.494780465546219,11
2008,"KS","Kansas",514765,699655,1214420,0.423877241810906,0.576122758189094,6
2008,"KY","Kentucky",751985,1048462,1800447,0.417665724122954,0.582334275877046,8
2008,"LA","Louisiana",782989,1148275,1931264,0.405428258384146,0.594571741615854,9
2008,"MA","Massachusetts",1904097,1108854,3012951,0.63197078213353,0.36802921786647,12
2008,"MD","Maryland",1629467,959862,2589329,0.629300872928855,0.370699127071145,10
2008,"ME","Maine",421923,295273,717196,0.588295249834076,0.411704750165924,4
2008,"MI","Michigan",2872579,2048639,4921218,0.583713015761545,0.416286984238455,17
2008,"MN","Minnesota",1573354,1275409,2848763,0.552293749953927,0.447706250046073,10
2008,"MO","Missouri",1441911,1445814,2887725,0.499324208503234,0.500675791496766,11
2008,"MS","Mississippi",554662,724597,1279259,0.433580690071362,0.566419309928638,6
2008,"MT","Montana",231667,242763,474430,0.488305967160593,0.511694032839407,3
2008,"NC","North Carolina",2142651,2128474,4271125,0.501659633000673,0.498340366999327,15
2008,"ND","North Dakota",141278,168601,309879,0.455913437180319,0.544086562819681,3
2008,"NE","Nebraska",333319,452979,786298,0.423909255778344,0.576090744221656,5
2008,"NH","New Hampshire",384826,316534,701360,0.548685411201095,0.451314588798905,4
2008,"NJ","New Jersey",2215422,1613207,3828629,0.578646298714239,0.42135370128576,15
2008,"NM","New Mexico",472422,346832,819254,0.576649000187976,0.423350999812024,5
2008,"NV","Nevada",533736,412827,946563,0.563867381251961,0.436132618748039,5
2008,"NY","New York",4804945,2752771,7557716,0.635766811031269,0.364233188968731,31
2008,"OH","Ohio",2940044,2677820,5617864,0.523338407622541,0.476661592377459,20
2008,"OK","Oklahoma",502496,960165,1462661,0.343549188773065,0.656450811226935,7
2008,"OR","Oregon",1037291,738475,1775766,0.584137211772272,0.415862788227728,7
2008,"PA","Pennsylvania",3276363,2655885,5932248,0.552297038154845,0.447702961845156,21
2008,"RI","Rhode Island",296571,165391,461962,0.641981375091458,0.358018624908542,4
2008,"SC","South Carolina",862449,1034896,1897345,0.454555708107909,0.545444291892091,8
2008,"SD","South Dakota",170924,203054,373978,0.457042927658846,0.542957072341154,3
2008,"TN","Tennessee",1087437,1479178,2566615,0.423685281976455,0.576314718023545,11
2008,"TX","Texas",3528633,4479328,8007961,0.440640632490593,0.559359367509407,34
2008,"UT","Utah",327670,596030,923700,0.354736386272599,0.645263613727401,5
2008,"VA","Virginia",1959532,1725005,3684537,0.531825844061276,0.468174155938724,13
2008,"VT","Vermont",219262,98974,318236,0.688991817393381,0.311008182606619,3
2008,"WA","Washington",1750848,1229216,2980064,0.587520268021089,0.412479731978911,11
2008,"WI","Wisconsin",1677211,1262393,2939604,0.570556782478184,0.429443217521816,10
2008,"WV","West Virginia",303857,397466,701323,0.433262562328627,0.566737437671373,5
2008,"WY","Wyoming",82868,164958,247826,0.334379766449041,0.665620233550959,3
2008,"US","United States",69498516,59948323,129446839,0.536888475121436,0.463111524878564,538
2012,"AK","Alaska",122640,164676,287316,0.426847095184396,0.573152904815604,3
2012,"AL","Alabama",795696,1255925,2051621,0.387837714665623,0.612162285334377,9
2012,"AR","Arkansas",394409,647744,1042153,0.378455946487704,0.621544053512296,6
2012,"AZ","Arizona",1025232,1233654,2258886,0.453866197762968,0.546133802237032,11
2012,"CA","California",7854285,4839958,12694243,0.618728111632966,0.381271888367034,55
2012,"CO","Colorado",1323102,1185243,2508345,0.527480071521262,0.472519928478738,9
2012,"CT","Connecticut",905083,634892,1539975,0.587725774769071,0.412274225230929,7
2012,"DC","D.C.",267070,21381,288451,0.925876492021175,0.0741235079788248,3
2012,"DE","Delaware",242584,165484,408068,0.594469549192782,0.405530450807218,3
2012,"FL","Florida",4237756,4163447,8401203,0.504422521393662,0.495577478606338,29
2012,"GA","Georgia",1773827,2078688,3852515,0.460433509019433,0.539566490980567,16
2012,"HI","Hawaii",306658,121015,427673,0.717038485010744,0.282961514989256,4
2012,"IA","Iowa",822544,730617,1553161,0.529593519281002,0.470406480718998,6
2012,"ID","Idaho",212787,420911,633698,0.335786131564247,0.664213868435753,4
2012,"IL","Illinois",3019512,2135216,5154728,0.585775233921169,0.414224766078831,20
2012,"IN","Indiana",1152887,1420543,2573430,0.447996254026727,0.552003745973273,11
2012,"KS","Kansas",440726,692634,1133360,0.388866732547469,0.61113326745253,6
2012,"KY","Kentucky",679370,1087190,1766560,0.384572276061951,0.615427723938049,8
2012,"LA","Louisiana",809141,1152262,1961403,0.41253174385886,0.58746825614114,8
2012,"MA","Massachusetts",1921290,1188314,3109604,0.6178568074906,0.3821431925094,11
2012,"MD","Maryland",1677844,971869,2649713,0.63321725786906,0.36678274213094,10
2012,"ME","Maine",401306,292276,693582,0.578599213935771,0.421400786064229,4
2012,"MI","Michigan",2564569,2115256,4679825,0.548005320711779,0.451994679288221,16
2012,"MN","Minnesota",1546167,1320225,2866392,0.539412264616982,0.460587735383018,10
2012,"MO","Missouri",1223796,1482440,2706236,0.4522133324662,0.5477866675338,10
2012,"MS","Mississippi",562949,710746,1273695,0.441981008012122,0.558018991987878,6
2012,"MT","Montana",201839,267928,469767,0.429657681361185,0.570342318638815,3
2012,"NC","North Carolina",2178391,2270395,4448786,0.48965965096995,0.51034034903005,15
2012,"ND","North Dakota",124827,188163,312990,0.398821048595802,0.601178951404198,3
2012,"NE","Nebraska",302081,475064,777145,0.388706097317746,0.611293902682254,5
2012,"NH","New Hampshire",369561,329918,699479,0.528337519782581,0.471662480217419,4
2012,"NJ","New Jersey",2125101,1477568,3602669,0.589868511373096,0.410131488626904,14
2012,"NM","New Mexico",415335,335788,751123,0.552952046469087,0.447047953530913,5
2012,"NV","Nevada",531373,463567,994940,0.534075421633465,0.465924578366535,6
2012,"NY","New York",4485741,2490431,6976172,0.643008945306968,0.356991054693032,29
2012,"OH","Ohio",2827709,2661437,5489146,0.51514552536952,0.48485447463048,18
2012,"OK","Oklahoma",443547,891325,1334872,0.332276802569834,0.667723197430166,7
2012,"OR","Oregon",970488,754175,1724663,0.562711671787474,0.437288328212526,7
2012,"PA","Pennsylvania",2990274,2680434,5670708,0.527319340018918,0.472680659981082,20
2012,"RI","Rhode Island",279677,157204,436881,0.640167459788821,0.359832540211179,4
2012,"SC","South Carolina",865941,1071645,1937586,0.446917452954346,0.553082547045654,9
2012,"SD","South Dakota",145039,210610,355649,0.407815008618048,0.592184991381952,3
2012,"TN","Tennessee",960709,1462330,2423039,0.39648928473706,0.60351071526294,11
2012,"TX","Texas",3308124,4569843,7877967,0.419921027848936,0.580078972151064,38
2012,"UT","Utah",251813,740600,992413,0.253738111048525,0.746261888951475,6
2012,"VA","Virginia",1971820,1822522,3794342,0.519673766887645,0.480326233112355,13
2012,"VT","Vermont",199239,92698,291937,0.682472588263906,0.317527411736094,3
2012,"WA","Washington",1755396,1290670,3046066,0.576282982706218,0.423717017293782,12
2012,"WI","Wisconsin",1620985,1407966,3028951,0.535163824043373,0.464836175956627,10
2012,"WV","West Virginia",238269,417655,655924,0.363257023679573,0.636742976320427,5
2012,"WY","Wyoming",69286,170962,240248,0.288393659884786,0.711606340115214,3
2012,"US","United States",65915795,60933504,126849299,0.519638622520098,0.480361377479902,538
2016,"AK","Alaska",116454,163387,279841,0.416143452889319,0.583856547110681,3
2016,"AL","Alabama",729547,1318255,2047802,0.356258564060393,0.643741435939607,9
2016,"AR","Arkansas",380494,684872,1065366,0.357148623102295,0.642851376897705,6
2016,"AZ","Arizona",1161167,1252401,2413568,0.481099765989605,0.518900234010395,11
2016,"CA","California",8753788,4483810,13237598,0.661282205427299,0.338717794572701,55
2016,"CO","Colorado",1338870,1202484,2541354,0.526833333726824,0.473166666273176,9
2016,"CT","Connecticut",897572,673215,1570787,0.571415475172636,0.428584524827364,7
2016,"DC","D.C.",282830,12723,295553,0.956951883418541,0.0430481165814592,3
2016,"DE","Delaware",235603,185127,420730,0.559986214436812,0.440013785563188,3
2016,"FL","Florida",4504975,4617886,9122861,0.493811645272245,0.506188354727755,29
2016,"GA","Georgia",1877963,2089104,3967067,0.473388274006968,0.526611725993032,16
2016,"HI","Hawaii",266891,128847,395738,0.674413374505355,0.325586625494645,4
2016,"IA","Iowa",653669,800983,1454652,0.449364521548797,0.550635478451203,6
2016,"ID","Idaho",189765,409055,598820,0.316898233191944,0.683101766808056,4
2016,"IL","Illinois",3090729,2146015,5236744,0.590200513907115,0.409799486092885,20
2016,"IN","Indiana",1033126,1557286,2590412,0.398826904754919,0.601173095245081,11
2016,"KS","Kansas",427005,671018,1098023,0.388885296573933,0.611114703426067,6
2016,"KY","Kentucky",628854,1202971,1831825,0.343293709824901,0.656706290175099,8
2016,"LA","Louisiana",780154,1178638,1958792,0.398283227621922,0.601716772378078,8
2016,"MA","Massachusetts",1995196,1090893,3086089,0.646512786896295,0.353487213103705,11
2016,"MD","Maryland",1677928,943169,2621097,0.640162496847694,0.359837503152306,10
2016,"ME","Maine",357735,335593,693328,0.515967911291625,0.484032088708375,4
2016,"MI","Michigan",2268839,2279543,4548382,0.498823317830385,0.501176682169616,16
2016,"MN","Minnesota",1367716,1322951,2690667,0.508318569336153,0.491681430663847,10
2016,"MO","Missouri",1071068,1594511,2665579,0.401814390044339,0.598185609955661,10
2016,"MS","Mississippi",485131,700714,1185845,0.409101526759399,0.590898473240601,6
2016,"MT","Montana",177709,279240,456949,0.388903356829756,0.611096643170244,3
2016,"NC","North Carolina",2189316,2362631,4551947,0.480962541962813,0.519037458037187,15
2016,"ND","North Dakota",93758,216794,310552,0.301907571034803,0.698092428965197,3
2016,"NE","Nebraska",284494,495961,780455,0.364523258868224,0.635476741131776,5
2016,"NH","New Hampshire",348526,345790,694316,0.501970284423807,0.498029715576193,4
2016,"NJ","New Jersey",2148278,1601933,3750211,0.572841901429013,0.427158098570987,14
2016,"NM","New Mexico",385234,319667,704901,0.546507949343241,0.453492050656759,5
2016,"NV","Nevada",539260,512058,1051318,0.512937094199852,0.487062905800148,6
2016,"NY","New York",4556124,2819534,7375658,0.617724411842306,0.382275588157694,29
2016,"OH","Ohio",2394164,2841005,5235169,0.457323154228641,0.542676845771359,18
2016,"OK","Oklahoma",420375,949136,1369511,0.306952627616719,0.693047372383281,7
2016,"OR","Oregon",1002106,782403,1784509,0.561558389450544,0.438441610549456,7
2016,"PA","Pennsylvania",2926441,2970733,5897174,0.496244641925098,0.503755358074902,20
2016,"RI","Rhode Island",252525,180543,433068,0.583107040926598,0.416892959073402,4
2016,"SC","South Carolina",855373,1155389,2010762,0.42539743639476,0.57460256360524,9
2016,"SD","South Dakota",117458,227721,345179,0.340281419205687,0.659718580794313,3
2016,"TN","Tennessee",870695,1522925,2393620,0.36375656954738,0.63624343045262,11
2016,"TX","Texas",3877868,4685047,8562915,0.45286774422028,0.54713225577972,38
2016,"UT","Utah",310676,515231,825907,0.376163417915092,0.623836582084908,6
2016,"VA","Virginia",1981473,1769443,3750916,0.528263762771547,0.471736237228453,13
2016,"VT","Vermont",178573,95369,273942,0.651864263238204,0.348135736761796,3
2016,"WA","Washington",1742718,1221747,2964465,0.587869312000648,0.412130687999352,12
2016,"WI","Wisconsin",1382536,1405284,2787820,0.495920109619703,0.504079890380297,10
2016,"WV","West Virginia",188794,489371,678165,0.278389477487042,0.721610522512958,5
2016,"WY","Wyoming",55973,174419,230392,0.242946803708462,0.757053196291538,3
2016,"US","United States",65853516,62984825,128838341,0.5111329087977,0.4888670912023,538

